***************
*           * *
*** ******* * *
*   *     *   *
* * ***** *** *
* *  *    * * *
* **** **** * *
*      *      *
***************